//status-overview
Status=Status
Overview=Przegląd
Access Point=Punkt dostepu
Wireless Client=Klient bezprzewodowy
Wireless Ethernet Bridge=Most Wi-Fi
B Only=Tylko B
G Only=Tylko G
B/G Mixed=Razem B/G
N Only=Tylko N
Enabled=Włączone
Disabled=Wyłączone
Version=Wersja
Name=Nazwa
Model=Model
Chipset=Chipset
CPU Freq=Częstotliwość CPU
Time=Czas
Uptime=uruchomiony od
mins=minut
CPU Load=Obciążenie CPU
Total / Free Memory=Całkowita / Wolna pamięć
Total / Free Swap=Całkowity / Wolny swap
MAC Address=Adres MAC
Connection Type=Typ połączenia
Static IP=Statyczny IP
IP Address=Adres IP
Subnet Mask=Maska podsieci
Gateway=Brama domyślna
IPv6 Address=Adres IPv6
Status=Status
Connection Uptime=Czas połączenia
Remaining Lease Time=Czas do utraty adresu
Renew=Odnów
Release=Zwolnij
Connect=Połącz
Disconnect=Rozłącz
Router MAC Address=Adres MAC routera
Router IP Address=Adres IP routera
Router IPv6 Address=Adres IPv6 routera
IPv6 Link-local Address=Adres połączeniowy IPv6
Wireless=Sieć bezprzewodowa
Wireless Mode=Tryb pracy
Wireless Network Mode=Standard Wi-Fi
Radio=Radio
Security=Zabezpieczenie
Channel=Kanał
Channel Width=Szerokość kanału
Interference Level=Poziom zakłócen
Rate=Prędkość
RSSI=RSSI
Noise=Szum
Signal Quality=Jakość sygnału
Enable=Włącz
Disable=Wyłącz

//tomato.js
Saving=Zapisywanie
Saved=Zapisano
Invalid=Nieprawidłowy
Valid range=Prawidłowy zakres
Invalid number of minutes=Nieprawidłowa liczba minut
Invalid MAC or IP address=Nie prawidlowy MAC lub adres IP
Invalid IP address range=Nieprawidlowy zakres adresow IP
Invalid IP address=Nieprawidlowy Adres IP
IP address outside of LAN=Adres IP jest poza LAN
Invalid IP address or port=Błędny adres IP lub numer portu
Invalid port=Błędny numer portu
invalid IP address range=Błędny zakres adresów IP
invalid netmask=nieprawidłowa maska
invalid IP address=błędny adres IP
Too many IP addresses=Za dużo adresów IP
Invalid name. Only characters=Błędna nazwa. Dozwolone tylko znaki
are allowed=są dozwolone
invalid IPv6 address range=błędny zakres adresów IPv6
invalid IPv6 address=błędny adres IPv6
invalid CIDR notation on IPv6 address=
Invalid port range=Nieprawidłowy zakres portow
Expecting a list of ports or port range=podziewana lista portów lub ich zakres
Only 10 ports/range sets are allowed=Dozwolony jest zbiór tylko 10 portów/zakresów
Invalid MAC address=Nieprawidłowy adres MAC
Invalid length. Please enter at least=Nieprawidłowa długosc. Proszę wprowadz conajmniej
character=znak
characters=znaków
Invalid length. Please reduce the length to=Nieprawidłowa długość. Proszę zredukuj długosc
characters or less=znaków lub mniej
Too many addresses=Za dużo adresów IP
Invalid domain name or IP address=Błędna nazwa domeny lub adres IP
or invalid domain name=lub niepoprawna nazwa domeny
Too many hostnames=Za dużo nazw hosta
Invalid hostname=Błędna nazwa hosta
Invalid=Nieprawidłowa
or=lub
are=są
is=jest
not allowed=niedozwolone
Please start at the / root directory=Proszę zacząć od / katalogu root
Move Up=Do góry
Move Down=W dół
Delete=Usuń
Click to edit=Kliknij aby edytować
Cancel=Anuluj
Add=Dodaj
Refresh=Odśwież
minute=minuta
minutes=minut
3 seconds=3 sekundy
4 seconds=4 sekundy
seconds=sekund
Auto Refresh=Autoodświeżanie
Status=Status
Overview=Przegląd
Device List=Lista urządzeń
Web Usage=Monitor sieci
Logs=Logi
Bandwidth=Przepustowość
Real-Time=Aktualnie
Last 24 Hours=Ostatnie 24h
Daily=Dziennie
Weekly=Tygodniowo
Monthly=Miesięcznie
Tools=Narzędzia
Ping=Ping
Trace=Trasa
System=Konsola systemowa
Wireless Survey=Szukanie Wi-Fi
WOL=Budzenie przez LAN
Basic=Podstawowe
Network=Sieć
Identification=Identyfikacja
DDNS=Dynamiczny DNS
Static DHCP=Statyczne DHCP
Wireless Filter=Filtrowanie Wi-Fi 
Advanced=Zaawansowane
Conntrack / Netfilter=Powiązania / Filtr sieciowy
DHCP / DNS=DHCP / DNS
Firewall=Zapora ogniowa
MAC Address=Adresy MAC
Miscellaneous=Różne
Routing=Routing
Wireless=Wi-Fi
Port Forwarding=Przekierowanie portów
Basic=Podstawowe
Triggered=Inicjowane
UPnP / NAT-PMP=UPnP / NAT-PMP
Basic Settings=Podstawowe ustawienia
Classification=Klasyfikacja
View Graphs=Pokaż wykres
View Details=Pokaż szczegóły
Transfer Rates=Limity transferu
RAF Features=Narzędzia RAF
MAC/IP Range BW Limit=Limitoranie łącza
ARP Binding=Bindowanie ARP
Access Restriction=Ustawienia dostępu
USB and NAS=USB i NAS
USB Support=Obsługa USB
FTP Server=Serwer FTP
File Sharing=Serwer SAMBA
Media Server=Serwer multimediów
BitTorrent Client=Klient torrentów
VPN Tunneling=Tunel OpenVPN
Server=Serwer
Client=Klient
Administration=Administracja
Admin Access=Dostęp administratora
Bandwidth Monitoring=Monitorowanie przepustowości
Buttons / LED=Przyciski / Diody
CIFS Client=Klient CIFS
Configuration=Konfiguracja
Debugging=Debugowanie
JFFS=JFFS
Logging=Logowanie
Scheduler=Harmonogram
Scripts=Skrypty
Upgrade=Aktualizacja
About=O tomato
Reboot=Restartuj
Shutdown=Wyłącz
Logout=Wyloguj




